=========S.=========
==========.=========
==========.=========
==========...=======
============.=======
==========...=======
==========.=========
==========..========
===========.========
=========...========
=========.==========
=========.==========
=========.....======
=============.======
=============.======
=============.======
=============.======
=============.======
=============.======
=E............======
