=========S.=========
==========.=========
==========.=========
==========...=======
============.=======
==========...=======
==========.=========
===...====..========
===.=.=====.========
===.=.......========
===.================
===.......==========
=========.....======
=============.==E===
=============.==.===
=============....===
====================
====================
====================
====================