=========S.=========
==========.=========
==========.=========
==========...=======
============.=======
==========...=======
====....==.====.====
====.=.==..==...====
======..==......====
====........===.====
.....==========.====
.===================
......==============
=====.==============
====....============
====.===============
====......==========
=========.==========
=========.==========
=========..........E
