=========S==========
=========.==========
=========.==========
=========.==========
=========.=====.====
=========.=====.====
=========.......====
=========.==========
=========.==========
=========.==========
=========.==========
=====.....==========
=====.===.==========
=====.===.==========
=========.==========
=========.==========
=========.==========
=========.==========
=========.==========
=========E==========
