=========S.=========
==========.=========
==========.....=====
==========...=======
======.=====.=======
======.===...=======
====....==.====.====
====.=.==..==...====
======..==.......===
====........===.====
.....==========.====
.================.==
......====........==
=====.====.===.=====
====.......===.=====
====.=========.=====
====......====.=====
=========.====.=====
=========.==========
=========..........E
