=========E==========
=========.==========
=========.==========
=========.==========
=========.==========
=========.==========
=========.==========
=========.==========
=========.==========
=========.==========
=========.==========
=========.==========
=========.==========
=========.==========
=========.==========
=========.==========
=========.==========
=========.==========
=========.==========
=========S==========
