=========S.=========
==========.=========
==========.=========
==========...=======
============.=======
==========...=======
==========.====.====
==========..==...===
===========.....====
========E...========
====================
====================
====================
====================
====================
====================
====================
====================
====================
====================
