=========S==========
=========.==========
=========.==========
=========.==========
=========.==========
=========.==========
=========.==========
=========.==========
=========.==========
=========.==========
=========.==========
=========.==========
=========.==========
=========.==========
=========.==========
=========.==========
=========.==========
=========.==========
=========.==========
=========E==========
