====================
====================
====================
====================
====================
=========.==========
=========.==========
======...S..========
======.==.==========
======.===.=========
======.....=========
========.===========
========.===========
========...=========
=========.=.==.=====
=========.......====
=========.====.=====
=.........==========
=.==================
=E==================